1111111111111
1001000000PC1
1000011111001
100011C1C0E01
1111111111111