11111111
1P0C0001
10000001
1E000001
11111111