1111111111111
1C000000000C1
1010011C11111
1P0011X0000E1
1111111111111