111111111111111111111111111111
10000000C000000001E100000000C1
1P0000C00000C0000000000000X0C1
111111111111111111111111111111