11111111111111111111111111111
1E0000000000000C00000000000C1
111C1111111111111111101111111
11101111111111111C11101111111
111011111C01C0000011101111111
11101111100000111101101111111
111011111111000C00111C1111111
111011C0011111111000C000000C1
11101111000000111011111111111
11101100011110111011111111111
1000000111111C111011111111111
1011110000C110111011111111111
1P111111011110111011111111111
10111111000000000011111111111
1X111111C11111111111111111111
11111111111111111111111111111