1111111111111
1000000000001
100000P000001
1000000000001
1111111111111