NO ./textures/wall_north.xpm
SO ./textures/wall_south.xpm
WE ./textures/wall_west.xpm
EA ./textures/wall_east.xpm
F R,G,B
C G,B,R

111111
100101
101001
1100N1
111111