NO ./x
SO ./x
WE ./x
EA ./x
F 0,0,0
C 0,0,0

1111
1001
1S01
1111