NO ./textures/wall_north.xpm
SO ./textures/wall_south.xpm
WE ./textures/wall_west.xpm
EA ./textures/wall_east.xpm

C 220,30,0
F 220,30,0

111111
100001
100S01

100001
111111
