NO ./textures/basic_NO.xpm
SO ./textures/basic_SO.xpm
WE ./textures/basic_WE.xpm
EA ./textures/basic_EA.xpm

C 220,10,10
F 65,65,65

111111
101001
10N001
100001
111111
101
111