NO ./textures/wall_north.xpm
SO ./textures/wall_south.xpm
WE ./textures/wall_west.xpm
EA ./textures/wall_east.xpm

F 125,100,0
C 0,0,0

111111111111111111111111111111
100000000000000001E10000000001
100000000000000000000000000001
111111111111111111111111111111