NO ./textures/basic_NO.xpm
SO ./textures/basic_SO.xpm
WE ./textures/basic_WE.xpm
EA ./textures/basic_EA.xpm

F 125,100,0
C 0,0,0

11111111111111111111111111111
10000000000000000000000000001
11101111111111111111101111111
11101111111111111011101111111
11101111100100000011101111111
11101111100000111101101111111
11101111111100000011101111111
11101100011111111000000000001
11101111000000111011111111111
11101100011110111011111111111
10000001111110111011111111111
10111100000110111011111111111
1N111111011110111011111111111
10111111000000000011111111111
10111111011111111111111111111
11111111111111111111111111111
