NO ./textures/wall_north.xpm
SO ./textures/wall_south.xpm
WE ./textures/wall_west.xpm
EA ./textures/wall_east.xpm

C 220,10,1
F 220,30,1

111111
1N00 1
100 01
10 001
111111